Field Name	Field Description
Proposed use of building	{'FieldType': 'Text', 'FieldName': 'Proposed use of building', 'FieldNameAlt': 'Proposed use of building', 'FieldFlags': '4096', 'FieldJustification': 'Left'}
Current use of building	{'FieldType': 'Text', 'FieldName': 'Current use of building', 'FieldNameAlt': 'Current use of building', 'FieldFlags': '4096', 'FieldJustification': 'Left'}
Description of proposed work	{'FieldType': 'Text', 'FieldName': 'Description of proposed work', 'FieldNameAlt': 'Description of proposed work', 'FieldFlags': '4096', 'FieldJustification': 'Left'}
Signature of applicant	{'FieldType': 'Signature', 'FieldName': 'Signature of applicant', 'FieldNameAlt': 'Signature of applicant', 'FieldFlags': '0', 'FieldJustification': 'Left'}
Description of designers work	{'FieldType': 'Text', 'FieldName': 'Description of designers work', 'FieldNameAlt': 'Description of designer&#8217;s work', 'FieldFlags': '4096', 'FieldJustification': 'Left'}
Signature of Designer	{'FieldType': 'Signature', 'FieldName': 'Signature of Designer', 'FieldNameAlt': 'Signature of Designer', 'FieldFlags': '0', 'FieldJustification': 'Left'}
Application submitted to ((Name of municipality, upper-tier municipality, board of health or conservation authority)	{'FieldType': 'Text', 'FieldName': 'Application submitted to ((Name of municipality, upper-tier municipality, board of health or conservation authority)', 'FieldNameAlt': 'Application submitted to ((Name of municipality, upper-tier municipality, board of health or conservation authority)', 'FieldFlags': '0', 'FieldJustification': 'Left'}
Project building number street name	{'FieldType': 'Text', 'FieldName': 'Project building number street name', 'FieldNameAlt': 'Project building number street name', 'FieldFlags': '0', 'FieldJustification': 'Left'}
Project unit number	{'FieldType': 'Text', 'FieldName': 'Project unit number', 'FieldNameAlt': 'Project unit number', 'FieldFlags': '0', 'FieldJustification': 'Left'}
Project Lot/Concession	{'FieldType': 'Text', 'FieldName': 'Project Lot/Concession', 'FieldNameAlt': 'Project Lot/Concession', 'FieldFlags': '0', 'FieldJustification': 'Left'}
Project postal code	{'FieldType': 'Text', 'FieldName': 'Project postal code', 'FieldNameAlt': 'Project postal code', 'FieldFlags': '0', 'FieldJustification': 'Left'}
Project plan number/other description	{'FieldType': 'Text', 'FieldName': 'Project plan number/other description', 'FieldNameAlt': 'Project plan number/other description', 'FieldFlags': '0', 'FieldJustification': 'Left'}
Project value estimated (in dollars)	{'FieldType': 'Text', 'FieldName': 'Project value estimated (in dollars)', 'FieldNameAlt': 'Project value estimated (in dollars)', 'FieldFlags': '0', 'FieldJustification': 'Left'}
Project area of work (in square metres)	{'FieldType': 'Text', 'FieldName': 'Project area of work (in square metres)', 'FieldNameAlt': 'Project area of work (in square metres)', 'FieldFlags': '0', 'FieldJustification': 'Left'}
Individual BCIN of Designer for Registered Firm	{'FieldType': 'Text', 'FieldName': 'Individual BCIN of Designer for Registered Firm', 'FieldNameAlt': 'Individual BCIN of Designer for Registered Firm', 'FieldFlags': '0', 'FieldJustification': 'Left'}
Firm BCINFirm BCIN of Designer for Registered Firm	{'FieldType': 'Text', 'FieldName': 'Firm BCINFirm BCIN of Designer for Registered Firm', 'FieldNameAlt': 'Firm BCIN of Designer for Registered Firm', 'FieldFlags': '0', 'FieldJustification': 'Left'}
Individual BCIN for Other Designer	{'FieldType': 'Text', 'FieldName': 'Individual BCIN for Other Designer', 'FieldNameAlt': 'Individual BCIN for Other Designer', 'FieldFlags': '0', 'FieldJustification': 'Left'}
Basis for exemption from registration for Other Designer	{'FieldType': 'Text', 'FieldName': 'Basis for exemption from registration for Other Designer', 'FieldNameAlt': 'Basis for exemption from registration for Other Designer', 'FieldFlags': '0', 'FieldJustification': 'Left'}
For design work, Basis for exemption from registration and qualification	{'FieldType': 'Text', 'FieldName': 'For design work, Basis for exemption from registration and qualification', 'FieldNameAlt': 'For design work, Basis for exemption from registration and qualification', 'FieldFlags': '0', 'FieldJustification': 'Left'}
Date Applicant Signed Main Form	{'FieldType': 'Text', 'FieldName': 'Date Applicant Signed Main Form', 'FieldNameAlt': 'Date Applicant Signed Main Form', 'FieldFlags': '0', 'FieldJustification': 'Left'}
Date Sewage System Installer Applicant Signed	{'FieldType': 'Text', 'FieldName': 'Date Sewage System Installer Applicant Signed', 'FieldNameAlt': 'Date Sewage System Installer Applicant Signed', 'FieldFlags': '0', 'FieldJustification': 'Left'}
Signature of Sewage System Installer Applicant	{'FieldType': 'Signature', 'FieldName': 'Signature of Sewage System Installer Applicant', 'FieldNameAlt': 'Signature of Sewage System Installer Applicant', 'FieldFlags': '0', 'FieldJustification': 'Left'}
Applicant last name	{'FieldType': 'Text', 'FieldName': 'Applicant last name', 'FieldNameAlt': 'Applicant last name', 'FieldFlags': '0', 'FieldJustification': 'Left'}
Applicant First name	{'FieldType': 'Text', 'FieldName': 'Applicant First name', 'FieldNameAlt': 'Applicant First name', 'FieldFlags': '0', 'FieldJustification': 'Left'}
Applicant Corporation or partnership	{'FieldType': 'Text', 'FieldName': 'Applicant Corporation or partnership', 'FieldNameAlt': 'Applicant Corporation or partnership', 'FieldFlags': '0', 'FieldJustification': 'Left'}
Applicant Street address	{'FieldType': 'Text', 'FieldName': 'Applicant Street address', 'FieldNameAlt': 'Applicant Street address', 'FieldFlags': '0', 'FieldJustification': 'Left'}
Applicant Unit number	{'FieldType': 'Text', 'FieldName': 'Applicant Unit number', 'FieldNameAlt': 'Applicant Unit number', 'FieldFlags': '0', 'FieldJustification': 'Left'}
Applicant Lot/Concession	{'FieldType': 'Text', 'FieldName': 'Applicant Lot/Concession', 'FieldNameAlt': 'Applicant Lot/Concession', 'FieldFlags': '0', 'FieldJustification': 'Left'}
Applicant Municipality	{'FieldType': 'Text', 'FieldName': 'Applicant Municipality', 'FieldNameAlt': 'Applicant Municipality', 'FieldFlags': '0', 'FieldJustification': 'Left'}
Applicant Postal code	{'FieldType': 'Text', 'FieldName': 'Applicant Postal code', 'FieldNameAlt': 'Applicant Postal code', 'FieldFlags': '0', 'FieldJustification': 'Left'}
Applicant Province	{'FieldType': 'Text', 'FieldName': 'Applicant Province', 'FieldNameAlt': 'Applicant Province', 'FieldFlags': '0', 'FieldJustification': 'Left'}
Applicant Email	{'FieldType': 'Text', 'FieldName': 'Applicant Email', 'FieldNameAlt': 'Applicant Email', 'FieldFlags': '0', 'FieldJustification': 'Left'}
Applicant Telephone number	{'FieldType': 'Text', 'FieldName': 'Applicant Telephone number', 'FieldNameAlt': 'Applicant Telephone number', 'FieldFlags': '0', 'FieldJustification': 'Left'}
Applicant Fax	{'FieldType': 'Text', 'FieldName': 'Applicant Fax', 'FieldNameAlt': 'Applicant Fax', 'FieldFlags': '0', 'FieldJustification': 'Left'}
Applicant Cell number	{'FieldType': 'Text', 'FieldName': 'Applicant Cell number', 'FieldNameAlt': 'Applicant Cell number', 'FieldFlags': '0', 'FieldJustification': 'Left'}
Owner Last name	{'FieldType': 'Text', 'FieldName': 'Owner Last name', 'FieldNameAlt': 'Owner Last name', 'FieldFlags': '0', 'FieldJustification': 'Left'}
Owner First name	{'FieldType': 'Text', 'FieldName': 'Owner First name', 'FieldNameAlt': 'Owner First name', 'FieldFlags': '0', 'FieldJustification': 'Left'}
Owner Corporation or partnership	{'FieldType': 'Text', 'FieldName': 'Owner Corporation or partnership', 'FieldNameAlt': 'Owner Corporation or partnership', 'FieldFlags': '0', 'FieldJustification': 'Left'}
Owner Street address	{'FieldType': 'Text', 'FieldName': 'Owner Street address', 'FieldNameAlt': 'Owner Street address', 'FieldFlags': '0', 'FieldJustification': 'Left'}
Owner Unit number	{'FieldType': 'Text', 'FieldName': 'Owner Unit number', 'FieldNameAlt': 'Owner Unit number', 'FieldFlags': '0', 'FieldJustification': 'Left'}
Owner Lot/Concession	{'FieldType': 'Text', 'FieldName': 'Owner Lot/Concession', 'FieldNameAlt': 'Owner Lot/Concession', 'FieldFlags': '0', 'FieldJustification': 'Left'}
Owner Municipality	{'FieldType': 'Text', 'FieldName': 'Owner Municipality', 'FieldNameAlt': 'Owner Municipality', 'FieldFlags': '0', 'FieldJustification': 'Left'}
Owner Postal code	{'FieldType': 'Text', 'FieldName': 'Owner Postal code', 'FieldNameAlt': 'Owner Postal code', 'FieldFlags': '0', 'FieldJustification': 'Left'}
Owner Province	{'FieldType': 'Text', 'FieldName': 'Owner Province', 'FieldNameAlt': 'Owner Province', 'FieldFlags': '0', 'FieldJustification': 'Left'}
Owner Email	{'FieldType': 'Text', 'FieldName': 'Owner Email', 'FieldNameAlt': 'Owner Email', 'FieldFlags': '0', 'FieldJustification': 'Left'}
Owner Telephone number	{'FieldType': 'Text', 'FieldName': 'Owner Telephone number', 'FieldNameAlt': 'Owner Telephone number', 'FieldFlags': '0', 'FieldJustification': 'Left'}
Owner Fax	{'FieldType': 'Text', 'FieldName': 'Owner Fax', 'FieldNameAlt': 'Owner Fax', 'FieldFlags': '0', 'FieldJustification': 'Left'}
Owner Cell number	{'FieldType': 'Text', 'FieldName': 'Owner Cell number', 'FieldNameAlt': 'Owner Cell number', 'FieldFlags': '0', 'FieldJustification': 'Left'}
Builder Last name	{'FieldType': 'Text', 'FieldName': 'Builder Last name', 'FieldNameAlt': 'Builder Last name', 'FieldFlags': '0', 'FieldJustification': 'Left'}
Builder First name	{'FieldType': 'Text', 'FieldName': 'Builder First name', 'FieldNameAlt': 'Builder First name', 'FieldFlags': '0', 'FieldJustification': 'Left'}
Builder Corporation or partnership (if applicable)	{'FieldType': 'Text', 'FieldName': 'Builder Corporation or partnership (if applicable)', 'FieldNameAlt': 'Builder Corporation or partnership (if applicable)', 'FieldFlags': '0', 'FieldJustification': 'Left'}
Builder Street address	{'FieldType': 'Text', 'FieldName': 'Builder Street address', 'FieldNameAlt': 'Builder Street address', 'FieldFlags': '0', 'FieldJustification': 'Left'}
Builder Unit number	{'FieldType': 'Text', 'FieldName': 'Builder Unit number', 'FieldNameAlt': 'Builder Unit number', 'FieldFlags': '0', 'FieldJustification': 'Left'}
Builder Lot/Concession	{'FieldType': 'Text', 'FieldName': 'Builder Lot/Concession', 'FieldNameAlt': 'Builder Lot/Concession', 'FieldFlags': '0', 'FieldJustification': 'Left'}
Builder Municipality	{'FieldType': 'Text', 'FieldName': 'Builder Municipality', 'FieldNameAlt': 'Builder Municipality', 'FieldFlags': '0', 'FieldJustification': 'Left'}
Builder Postal code	{'FieldType': 'Text', 'FieldName': 'Builder Postal code', 'FieldNameAlt': 'Builder Postal code', 'FieldFlags': '0', 'FieldJustification': 'Left'}
Builder Province	{'FieldType': 'Text', 'FieldName': 'Builder Province', 'FieldNameAlt': 'Builder Province', 'FieldFlags': '0', 'FieldJustification': 'Left'}
Builder Email	{'FieldType': 'Text', 'FieldName': 'Builder Email', 'FieldNameAlt': 'Builder Email', 'FieldFlags': '0', 'FieldJustification': 'Left'}
Builder Telephone number	{'FieldType': 'Text', 'FieldName': 'Builder Telephone number', 'FieldNameAlt': 'Builder Telephone number', 'FieldFlags': '0', 'FieldJustification': 'Left'}
Builder Fax	{'FieldType': 'Text', 'FieldName': 'Builder Fax', 'FieldNameAlt': 'Builder Fax', 'FieldFlags': '0', 'FieldJustification': 'Left'}
Builder Cell number	{'FieldType': 'Text', 'FieldName': 'Builder Cell number', 'FieldNameAlt': 'Builder Cell number', 'FieldFlags': '0', 'FieldJustification': 'Left'}
If registration is required under Ontario New Home Warranties Plan Act, provide registration number(s)	{'FieldType': 'Text', 'FieldName': 'If registration is required under Ontario New Home Warranties Plan Act, provide registration number(s)', 'FieldNameAlt': 'If registration is required under Ontario New Home Warranties Plan Act, provide registration number(s)', 'FieldFlags': '0', 'FieldJustification': 'Left'}
Designer Name	{'FieldType': 'Text', 'FieldName': 'Designer Name', 'FieldNameAlt': 'Designer Name', 'FieldFlags': '0', 'FieldJustification': 'Center'}
Designer Firm	{'FieldType': 'Text', 'FieldName': 'Designer Firm', 'FieldNameAlt': 'Designer Firm', 'FieldFlags': '0', 'FieldJustification': 'Left'}
Project Building number street name for Designer Information	{'FieldType': 'Text', 'FieldName': 'Project Building number street name for Designer Information', 'FieldNameAlt': 'Project Building number street name for Designer Information', 'FieldFlags': '0', 'FieldJustification': 'Left'}
Project Unit number for Designer Information	{'FieldType': 'Text', 'FieldName': 'Project Unit number for Designer Information', 'FieldNameAlt': 'Project Unit number for Designer Information', 'FieldFlags': '0', 'FieldJustification': 'Left'}
Project Lot/Concession for Designer Information	{'FieldType': 'Text', 'FieldName': 'Project Lot/Concession for Designer Information', 'FieldNameAlt': 'Project Lot/Concession for Designer Information', 'FieldFlags': '0', 'FieldJustification': 'Left'}
Project Municipality for Designer Information	{'FieldType': 'Text', 'FieldName': 'Project Municipality for Designer Information', 'FieldNameAlt': 'Project Municipality for Designer Information', 'FieldFlags': '0', 'FieldJustification': 'Left'}
Project Postal code for Designer Information	{'FieldType': 'Text', 'FieldName': 'Project Postal code for Designer Information', 'FieldNameAlt': 'Project Postal code for Designer Information', 'FieldFlags': '0', 'FieldJustification': 'Left'}
Project Plan number / other description for Designer Information	{'FieldType': 'Text', 'FieldName': 'Project Plan number / other description for Designer Information', 'FieldNameAlt': 'Project Plan number / other description for Designer Information', 'FieldFlags': '0', 'FieldJustification': 'Left'}
Designer Street address	{'FieldType': 'Text', 'FieldName': 'Designer Street address', 'FieldNameAlt': 'Designer Street address', 'FieldFlags': '0', 'FieldJustification': 'Left'}
Designer Unit no	{'FieldType': 'Text', 'FieldName': 'Designer Unit no', 'FieldNameAlt': 'Designer Unit no', 'FieldFlags': '0', 'FieldJustification': 'Left'}
Designer Lot/Concession	{'FieldType': 'Text', 'FieldName': 'Designer Lot/Concession', 'FieldNameAlt': 'Designer Lot/Concession', 'FieldFlags': '0', 'FieldJustification': 'Left'}
Designer Municipality	{'FieldType': 'Text', 'FieldName': 'Designer Municipality', 'FieldNameAlt': 'Designer Municipality', 'FieldFlags': '0', 'FieldJustification': 'Left'}
Designer Postal code	{'FieldType': 'Text', 'FieldName': 'Designer Postal code', 'FieldNameAlt': 'Designer Postal code', 'FieldFlags': '0', 'FieldJustification': 'Left'}
Designer Province	{'FieldType': 'Text', 'FieldName': 'Designer Province', 'FieldNameAlt': 'Designer Province', 'FieldFlags': '0', 'FieldJustification': 'Left'}
Designer Email	{'FieldType': 'Text', 'FieldName': 'Designer Email', 'FieldNameAlt': 'Designer Email', 'FieldFlags': '0', 'FieldJustification': 'Left'}
Designer Telephone number	{'FieldType': 'Text', 'FieldName': 'Designer Telephone number', 'FieldNameAlt': 'Designer Telephone number', 'FieldFlags': '0', 'FieldJustification': 'Left'}
Designer Fax number	{'FieldType': 'Text', 'FieldName': 'Designer Fax number', 'FieldNameAlt': 'Designer Fax number', 'FieldFlags': '0', 'FieldJustification': 'Left'}
Designer Cell number	{'FieldType': 'Text', 'FieldName': 'Designer Cell number', 'FieldNameAlt': 'Designer Cell number', 'FieldFlags': '0', 'FieldJustification': 'Left'}
Designer Name for Declaration	{'FieldType': 'Text', 'FieldName': 'Designer Name for Declaration', 'FieldNameAlt': 'Designer Name for Declaration', 'FieldFlags': '0', 'FieldJustification': 'Center'}
Date Signed by Designer	{'FieldType': 'Text', 'FieldName': 'Date Signed by Designer', 'FieldNameAlt': 'Date Signed by Designer', 'FieldFlags': '0', 'FieldJustification': 'Left'}
Project Building number street name for Sewage System Installer	{'FieldType': 'Text', 'FieldName': 'Project Building number street name for Sewage System Installer', 'FieldNameAlt': 'Project Building number street name for Sewage System Installer', 'FieldFlags': '0', 'FieldJustification': 'Left'}
Project Unit number for Sewage System Installer	{'FieldType': 'Text', 'FieldName': 'Project Unit number for Sewage System Installer', 'FieldNameAlt': 'Project Unit number for Sewage System Installer', 'FieldFlags': '0', 'FieldJustification': 'Left'}
Project Lot/Concession for Sewage System Installer	{'FieldType': 'Text', 'FieldName': 'Project Lot/Concession for Sewage System Installer', 'FieldNameAlt': 'Project Lot/Concession for Sewage System Installer', 'FieldFlags': '0', 'FieldJustification': 'Left'}
Project Municipality	{'FieldType': 'Text', 'FieldName': 'Project Municipality', 'FieldNameAlt': 'Project Municipality', 'FieldFlags': '0', 'FieldJustification': 'Left'}
Project Municipality for Sewage System Installer	{'FieldType': 'Text', 'FieldName': 'Project Municipality for Sewage System Installer', 'FieldNameAlt': 'Project Municipality for Sewage System Installer', 'FieldFlags': '0', 'FieldJustification': 'Left'}
Project Postal code for Sewage System Installer	{'FieldType': 'Text', 'FieldName': 'Project Postal code for Sewage System Installer', 'FieldNameAlt': 'Project Postal code for Sewage System Installer', 'FieldFlags': '0', 'FieldJustification': 'Left'}
Project Plan number other description for Sewage System Installer	{'FieldType': 'Text', 'FieldName': 'Project Plan number other description for Sewage System Installer', 'FieldNameAlt': 'Project Plan number other description for Sewage System Installer', 'FieldFlags': '0', 'FieldJustification': 'Left'}
Section C - Installer Name	{'FieldType': 'Text', 'FieldName': 'Section C - Installer Name', 'FieldNameAlt': 'Section C - Installer Name', 'FieldFlags': '0', 'FieldJustification': 'Left'}
Section C - Installer BCIN	{'FieldType': 'Text', 'FieldName': 'Section C - Installer BCIN', 'FieldNameAlt': 'Section C - Installer BCIN', 'FieldFlags': '0', 'FieldJustification': 'Left'}
Section C - Installer Street address	{'FieldType': 'Text', 'FieldName': 'Section C - Installer Street address', 'FieldNameAlt': 'Section C - Installer Street address', 'FieldFlags': '0', 'FieldJustification': 'Left'}
Section C - Installer Unit number	{'FieldType': 'Text', 'FieldName': 'Section C - Installer Unit number', 'FieldNameAlt': 'Section C - Installer Unit number', 'FieldFlags': '0', 'FieldJustification': 'Left'}
Section C - Installer Lot/Concession	{'FieldType': 'Text', 'FieldName': 'Section C - Installer Lot/Concession', 'FieldNameAlt': 'Section C - Installer Lot/Concession', 'FieldFlags': '0', 'FieldJustification': 'Left'}
Section C - Installer Municipality	{'FieldType': 'Text', 'FieldName': 'Section C - Installer Municipality', 'FieldNameAlt': 'Section C - Installer Municipality', 'FieldFlags': '0', 'FieldJustification': 'Left'}
Section C - Installer Postal code	{'FieldType': 'Text', 'FieldName': 'Section C - Installer Postal code', 'FieldNameAlt': 'Section C - Installer Postal code', 'FieldFlags': '0', 'FieldJustification': 'Left'}
Section C - Installer Province	{'FieldType': 'Text', 'FieldName': 'Section C - Installer Province', 'FieldNameAlt': 'Section C - Installer Province', 'FieldFlags': '0', 'FieldJustification': 'Left'}
Section C - Installer Email	{'FieldType': 'Text', 'FieldName': 'Section C - Installer Email', 'FieldNameAlt': 'Section C - Installer Email', 'FieldFlags': '0', 'FieldJustification': 'Left'}
Section C - Installer Telephone number	{'FieldType': 'Text', 'FieldName': 'Section C - Installer Telephone number', 'FieldNameAlt': 'Section C - Installer Telephone number', 'FieldFlags': '0', 'FieldJustification': 'Left'}
Section C - Installer Fax	{'FieldType': 'Text', 'FieldName': 'Section C - Installer Fax', 'FieldNameAlt': 'Section C - Installer Fax', 'FieldFlags': '0', 'FieldJustification': 'Left'}
Section C - Installer Cell number	{'FieldType': 'Text', 'FieldName': 'Section C - Installer Cell number', 'FieldNameAlt': 'Section C - Installer Cell number', 'FieldFlags': '0', 'FieldJustification': 'Left'}
Section D - Name of qualified supervisor(s)	{'FieldType': 'Text', 'FieldName': 'Section D - Name of qualified supervisor(s)', 'FieldNameAlt': 'Section D - Name of qualified supervisor(s)', 'FieldFlags': '4096', 'FieldJustification': 'Left'}
Section D - Building Code Identification Number (BCIN)	{'FieldType': 'Text', 'FieldName': 'Section D - Building Code Identification Number (BCIN)', 'FieldNameAlt': 'Section D - Building Code Identification Number (BCIN)', 'FieldFlags': '4096', 'FieldJustification': 'Left'}
Purpose: New construction	{'FieldType': 'Button', 'FieldName': 'Purpose: New construction', 'FieldNameAlt': 'Purpose: New construction', 'FieldFlags': '0', 'FieldJustification': 'Left', 'FieldStateOption': ['Off', 'Yes']}
Purpose: Addition to an existing building	{'FieldType': 'Button', 'FieldName': 'Purpose: Addition to an existing building', 'FieldNameAlt': 'Purpose: Addition to an existing building', 'FieldFlags': '0', 'FieldJustification': 'Left', 'FieldStateOption': ['Off', 'Yes']}
Purpose: Alteration/Repair	{'FieldType': 'Button', 'FieldName': 'Purpose: Alteration/Repair', 'FieldNameAlt': 'Purpose: Alteration/Repair', 'FieldFlags': '0', 'FieldJustification': 'Left', 'FieldStateOption': ['Off', 'Yes']}
Purpose: Demolition	{'FieldType': 'Button', 'FieldName': 'Purpose: Demolition', 'FieldNameAlt': 'Purpose: Demolition', 'FieldFlags': '0', 'FieldJustification': 'Left', 'FieldStateOption': ['Off', 'Yes']}
Purpose: Conditional Permit	{'FieldType': 'Button', 'FieldName': 'Purpose: Conditional Permit', 'FieldNameAlt': 'Purpose: Conditional Permit', 'FieldFlags': '0', 'FieldJustification': 'Left', 'FieldStateOption': ['Off', 'Yes']}
Applicant is: Owner	{'FieldType': 'Button', 'FieldName': 'Applicant is: Owner', 'FieldNameAlt': 'Applicant is: Owner', 'FieldFlags': '0', 'FieldJustification': 'Left', 'FieldStateOption': ['Off', 'Yes']}
Applicant is: Authorized agent of owner	{'FieldType': 'Button', 'FieldName': 'Applicant is: Authorized agent of owner', 'FieldNameAlt': 'Applicant is: Authorized agent of owner', 'FieldFlags': '0', 'FieldJustification': 'Left', 'FieldStateOption': ['Off', 'Yes']}
Is proposed construction for a new home as defined in the Ontario New Home Warranties Plan Act? NO (Go to section G.)	{'FieldType': 'Button', 'FieldName': 'Is proposed construction for a new home as defined in the Ontario New Home Warranties Plan Act? NO (Go to section G.)', 'FieldNameAlt': 'Is proposed construction for a new home as defined in the Ontario New Home Warranties Plan Act? NO (Go to section G.)', 'FieldFlags': '0', 'FieldJustification': 'Left', 'FieldStateOption': ['No', 'Off']}
Is proposed construction for a new home as defined in the Ontario New Home Warranties Plan Act? YES	{'FieldType': 'Button', 'FieldName': 'Is proposed construction for a new home as defined in the Ontario New Home Warranties Plan Act? YES', 'FieldNameAlt': 'Is proposed construction for a new home as defined in the Ontario New Home Warranties Plan Act? YES', 'FieldFlags': '0', 'FieldJustification': 'Left', 'FieldStateOption': ['Off', 'Yes']}
Is registration required under the Ontario New Home Warranties Plan Act? YES	{'FieldType': 'Button', 'FieldName': 'Is registration required under the Ontario New Home Warranties Plan Act? YES', 'FieldNameAlt': 'Is registration required under the Ontario New Home Warranties Plan Act? YES', 'FieldFlags': '0', 'FieldJustification': 'Left', 'FieldStateOption': ['Off', 'Yes']}
Is registration required under the Ontario New Home Warranties Plan Act? NO	{'FieldType': 'Button', 'FieldName': 'Is registration required under the Ontario New Home Warranties Plan Act? NO', 'FieldNameAlt': 'Is registration required under the Ontario New Home Warranties Plan Act? NO', 'FieldFlags': '0', 'FieldJustification': 'Left', 'FieldStateOption': ['No', 'Off']}
This application meets all the requirements of clauses 1.3.1.3 (5) (a) to (d) of Division C of the Building Code (the application is made in the correct form and by the owner or authorized agent,  all applicable fields have been completed on the application and required schedules, and all required schedules are submitted) YES	{'FieldType': 'Button', 'FieldName': 'This application meets all the requirements of clauses 1.3.1.3 (5) (a) to (d) of Division C of the Building Code (the application is made in the correct form and by the owner or authorized agent,  all applicable fields have been completed on the application and required schedules, and all required schedules are submitted) YES', 'FieldNameAlt': 'This application meets all the requirements of clauses 1.3.1.3 (5) (a) to (d) of Division C of the Building Code (the application is made in the correct form and by the owner or authorized agent,  all applicable fields have been completed on the application and required schedules, and all required schedules are submitted) YES', 'FieldFlags': '0', 'FieldJustification': 'Left', 'FieldStateOption': ['Off', 'Yes']}
This application meets all the requirements of clauses 1.3.1.3 (5) (a) to (d) of Division C of the Building Code (the application is made in the correct form and by the owner or authorized agent,  all applicable fields have been completed on the application and required schedules, and all required schedules are submitted) NO	{'FieldType': 'Button', 'FieldName': 'This application meets all the requirements of clauses 1.3.1.3 (5) (a) to (d) of Division C of the Building Code (the application is made in the correct form and by the owner or authorized agent,  all applicable fields have been completed on the application and required schedules, and all required schedules are submitted) NO', 'FieldNameAlt': 'This application meets all the requirements of clauses 1.3.1.3 (5) (a) to (d) of Division C of the Building Code (the application is made in the correct form and by the owner or authorized agent,  all applicable fields have been completed on the application and required schedules, and all required schedules are submitted) NO', 'FieldFlags': '0', 'FieldJustification': 'Left', 'FieldStateOption': ['No', 'Off']}
This application meets all the requirements of clauses 1.3	{'FieldType': '', 'FieldName': 'This application meets all the requirements of clauses 1.3', 'FieldFlags': '0', 'FieldJustification': 'Left'}
This application meets all the requirements of clauses 1	{'FieldType': '', 'FieldName': 'This application meets all the requirements of clauses 1', 'FieldFlags': '0', 'FieldJustification': 'Left'}
Payment has been made of all fees that are required, under the applicable by-law, resolution or regulation made under clause 7(1)(c) of the Building Code Act, 1992, to be paid when the application is made. YES	{'FieldType': 'Button', 'FieldName': 'Payment has been made of all fees that are required, under the applicable by-law, resolution or regulation made under clause 7(1)(c) of the Building Code Act, 1992, to be paid when the application is made. YES', 'FieldNameAlt': 'Payment has been made of all fees that are required, under the applicable by-law, resolution or regulation made under clause 7(1)(c) of the Building Code Act, 1992, to be paid when the application is made. YES', 'FieldFlags': '0', 'FieldJustification': 'Left', 'FieldStateOption': ['Off', 'Yes']}
Payment has been made of all fees that are required, under the applicable by-law, resolution or regulation made under clause 7(1)(c) of the Building Code Act, 1992, to be paid when the application is made. NO	{'FieldType': 'Button', 'FieldName': 'Payment has been made of all fees that are required, under the applicable by-law, resolution or regulation made under clause 7(1)(c) of the Building Code Act, 1992, to be paid when the application is made. NO', 'FieldNameAlt': 'Payment has been made of all fees that are required, under the applicable by-law, resolution or regulation made under clause 7(1)(c) of the Building Code Act, 1992, to be paid when the application is made. NO', 'FieldFlags': '0', 'FieldJustification': 'Left', 'FieldStateOption': ['No', 'Off']}
This application is accompanied by the plans and specifications prescribed by the applicable by-law, resolution or regulation made under clause 7(1)(b) of the Building Code Act, 1992. YES	{'FieldType': 'Button', 'FieldName': 'This application is accompanied by the plans and specifications prescribed by the applicable by-law, resolution or regulation made under clause 7(1)(b) of the Building Code Act, 1992. YES', 'FieldNameAlt': 'This application is accompanied by the plans and specifications prescribed by the applicable by-law, resolution or regulation made under clause 7(1)(b) of the Building Code Act, 1992. YES', 'FieldFlags': '0', 'FieldJustification': 'Left', 'FieldStateOption': ['Off', 'Yes']}
This application is accompanied by the plans and specifications prescribed by the applicable by-law, resolution or regulation made under clause 7(1)(b) of the Building Code Act, 1992. NO	{'FieldType': 'Button', 'FieldName': 'This application is accompanied by the plans and specifications prescribed by the applicable by-law, resolution or regulation made under clause 7(1)(b) of the Building Code Act, 1992. NO', 'FieldNameAlt': 'This application is accompanied by the plans and specifications prescribed by the applicable by-law, resolution or regulation made under clause 7(1)(b) of the Building Code Act, 1992. NO', 'FieldFlags': '0', 'FieldJustification': 'Left', 'FieldStateOption': ['No', 'Off']}
This application is accompanied by the information and documents prescribed by the applicable by- law, resolution or regulation made under clause 7(1)(b) of the Building Code Act, 1992 which enable the chief building official to determine whether the proposed building, construction or demolition will contravene any applicable law. YES	{'FieldType': 'Button', 'FieldName': 'This application is accompanied by the information and documents prescribed by the applicable by- law, resolution or regulation made under clause 7(1)(b) of the Building Code Act, 1992 which enable the chief building official to determine whether the proposed building, construction or demolition will contravene any applicable law. YES', 'FieldNameAlt': 'This application is accompanied by the information and documents prescribed by the applicable by- law, resolution or regulation made under clause 7(1)(b) of the Building Code Act, 1992 which enable the chief building official to determine whether the proposed building, construction or demolition will contravene any applicable law. YES', 'FieldFlags': '0', 'FieldJustification': 'Left', 'FieldStateOption': ['Off', 'Yes']}
This application is accompanied by the information and documents prescribed by the applicable by- law, resolution or regulation made under clause 7(1)(b) of the Building Code Act, 1992 which enable the chief building official to determine whether the proposed building, construction or demolition will contravene any applicable law. NO	{'FieldType': 'Button', 'FieldName': 'This application is accompanied by the information and documents prescribed by the applicable by- law, resolution or regulation made under clause 7(1)(b) of the Building Code Act, 1992 which enable the chief building official to determine whether the proposed building, construction or demolition will contravene any applicable law. NO', 'FieldNameAlt': 'This application is accompanied by the information and documents prescribed by the applicable by- law, resolution or regulation made under clause 7(1)(b) of the Building Code Act, 1992 which enable the chief building official to determine whether the proposed building, construction or demolition will contravene any applicable law. NO', 'FieldFlags': '0', 'FieldJustification': 'Left', 'FieldStateOption': ['No', 'Off']}
The proposed building, construction or demolition will not contravene any applicable law. YES	{'FieldType': 'Button', 'FieldName': 'The proposed building, construction or demolition will not contravene any applicable law. YES', 'FieldNameAlt': 'The proposed building, construction or demolition will not contravene any applicable law. YES', 'FieldFlags': '0', 'FieldJustification': 'Left', 'FieldStateOption': ['Off', 'Yes']}
The proposed building, construction or demolition will not contravene any applicable law. NO	{'FieldType': 'Button', 'FieldName': 'The proposed building, construction or demolition will not contravene any applicable law. NO', 'FieldNameAlt': 'The proposed building, construction or demolition will not contravene any applicable law. NO', 'FieldFlags': '0', 'FieldJustification': 'Left', 'FieldStateOption': ['No', 'Off']}
Design Activities: House	{'FieldType': 'Button', 'FieldName': 'Design Activities: House', 'FieldNameAlt': 'Design Activities: House', 'FieldFlags': '0', 'FieldJustification': 'Left', 'FieldStateOption': ['Off', 'Yes']}
Design Activities: Small Buildings	{'FieldType': 'Button', 'FieldName': 'Design Activities: Small Buildings', 'FieldNameAlt': 'Design Activities: Small Buildings', 'FieldFlags': '0', 'FieldJustification': 'Left', 'FieldStateOption': ['Off', 'Yes']}
Design Activities: Large Buildings	{'FieldType': 'Button', 'FieldName': 'Design Activities: Large Buildings', 'FieldNameAlt': 'Design Activities: Large Buildings', 'FieldFlags': '0', 'FieldJustification': 'Left', 'FieldStateOption': ['Off', 'Yes']}
Design Activities: Complex Buildings	{'FieldType': 'Button', 'FieldName': 'Design Activities: Complex Buildings', 'FieldNameAlt': 'Design Activities: Complex Buildings', 'FieldFlags': '0', 'FieldJustification': 'Left', 'FieldStateOption': ['Off', 'Yes']}
Design Activities: HVAC - House	{'FieldType': 'Button', 'FieldName': 'Design Activities: HVAC - House', 'FieldNameAlt': 'Design Activities: HVAC - House', 'FieldFlags': '0', 'FieldJustification': 'Left', 'FieldStateOption': ['Off', 'Yes']}
Design Activities: Building Services	{'FieldType': 'Button', 'FieldName': 'Design Activities: Building Services', 'FieldNameAlt': 'Design Activities: Building Services', 'FieldFlags': '0', 'FieldJustification': 'Left', 'FieldStateOption': ['Off', 'Yes']}
Design Activities: Detection, Lighting and Power	{'FieldType': 'Button', 'FieldName': 'Design Activities: Detection, Lighting and Power', 'FieldNameAlt': 'Design Activities: Detection, Lighting and Power', 'FieldFlags': '0', 'FieldJustification': 'Left', 'FieldStateOption': ['Off', 'Yes']}
Design Activities: Fire Protection	{'FieldType': 'Button', 'FieldName': 'Design Activities: Fire Protection', 'FieldNameAlt': 'Design Activities: Fire Protection', 'FieldFlags': '0', 'FieldJustification': 'Left', 'FieldStateOption': ['Off', 'Yes']}
Design Activities: Building Structural	{'FieldType': 'Button', 'FieldName': 'Design Activities: Building Structural', 'FieldNameAlt': 'Design Activities: Building Structural', 'FieldFlags': '0', 'FieldJustification': 'Left', 'FieldStateOption': ['Off', 'Yes']}
Design Activities: Plumbing - House	{'FieldType': 'Button', 'FieldName': 'Design Activities: Plumbing - House', 'FieldNameAlt': 'Design Activities: Plumbing - House', 'FieldFlags': '0', 'FieldJustification': 'Left', 'FieldStateOption': ['Off', 'Yes']}
Design Activities: Plumbing - All Buildings	{'FieldType': 'Button', 'FieldName': 'Design Activities: Plumbing - All Buildings', 'FieldNameAlt': 'Design Activities: Plumbing - All Buildings', 'FieldFlags': '0', 'FieldJustification': 'Left', 'FieldStateOption': ['Off', 'Yes']}
Design Activities: On-site Sewage Systems	{'FieldType': 'Button', 'FieldName': 'Design Activities: On-site Sewage Systems', 'FieldNameAlt': 'Design Activities: On-site Sewage Systems', 'FieldFlags': '0', 'FieldJustification': 'Left', 'FieldStateOption': ['Off', 'Yes']}
Is the installer of the sewage system engaged in the business of constructing on-site, installing, repairing, servicing, cleaning or emptying sewage systems, in accordance with Building Code Article 3.3.1.1, Division C? NO (Continue to Section E)	{'FieldType': 'Button', 'FieldName': 'Is the installer of the sewage system engaged in the business of constructing on-site, installing, repairing, servicing, cleaning or emptying sewage systems, in accordance with Building Code Article 3.3.1.1, Division C? NO (Continue to Section E)', 'FieldNameAlt': 'Is the installer of the sewage system engaged in the business of constructing on-site, installing, repairing, servicing, cleaning or emptying sewage systems, in accordance with Building Code Article 3.3.1.1, Division C? NO (Continue to Section E)', 'FieldFlags': '0', 'FieldJustification': 'Left', 'FieldStateOption': ['No', 'Off']}
Is the installer of the sewage system engaged in the business of constructing on-site, installing, repairing, servicing, cleaning or emptying sewage systems, in accordance with Building Code Article 3.3.1.1, Division C? YES (Continue to Section C)	{'FieldType': 'Button', 'FieldName': 'Is the installer of the sewage system engaged in the business of constructing on-site, installing, repairing, servicing, cleaning or emptying sewage systems, in accordance with Building Code Article 3.3.1.1, Division C? YES (Continue to Section C)', 'FieldNameAlt': 'Is the installer of the sewage system engaged in the business of constructing on-site, installing, repairing, servicing, cleaning or emptying sewage systems, in accordance with Building Code Article 3.3.1.1, Division C? YES (Continue to Section C)', 'FieldFlags': '0', 'FieldJustification': 'Left', 'FieldStateOption': ['Off', 'Yes']}
Is the installer of the sewage system engaged in the business of constructing on-site, installing, repairing, servicing, cleaning or emptying sewage systems, in accordance with Building Code Article 3.3.1.1, Division C? Installer unknown at time of application (Continue to Section E)	{'FieldType': 'Button', 'FieldName': 'Is the installer of the sewage system engaged in the business of constructing on-site, installing, repairing, servicing, cleaning or emptying sewage systems, in accordance with Building Code Article 3.3.1.1, Division C? Installer unknown at time of application (Continue to Section E)', 'FieldNameAlt': 'Is the installer of the sewage system engaged in the business of constructing on-site, installing, repairing, servicing, cleaning or emptying sewage systems, in accordance with Building Code Article 3.3.1.1, Division C? Installer unknown at time of application (Continue to Section E)', 'FieldFlags': '0', 'FieldJustification': 'Left', 'FieldStateOption': ['Off', 'Yes']}
Is the installer of the sewage system engaged in the business of constructing on-site, installing, repairing, servicing, cleaning or emptying sewage systems, in accordance with Building Code Article 3.3	{'FieldType': '', 'FieldName': 'Is the installer of the sewage system engaged in the business of constructing on-site, installing, repairing, servicing, cleaning or emptying sewage systems, in accordance with Building Code Article 3.3', 'FieldFlags': '0', 'FieldJustification': 'Left'}
Is the installer of the sewage system engaged in the business of constructing on-site, installing, repairing, servicing, cleaning or emptying sewage systems, in accordance with Building Code Article 3	{'FieldType': '', 'FieldName': 'Is the installer of the sewage system engaged in the business of constructing on-site, installing, repairing, servicing, cleaning or emptying sewage systems, in accordance with Building Code Article 3', 'FieldFlags': '0', 'FieldJustification': 'Left'}
Section E: Sewage System Installer Applicant Name	{'FieldType': 'Text', 'FieldName': 'Section E: Sewage System Installer Applicant Name', 'FieldNameAlt': 'Section E: Sewage System Installer Applicant Name', 'FieldFlags': '0', 'FieldJustification': 'Center'}
Name of Applicant for Declaration	{'FieldType': 'Text', 'FieldName': 'Name of Applicant for Declaration', 'FieldNameAlt': 'Name of Applicant for Declaration', 'FieldFlags': '0', 'FieldJustification': 'Left'}
